~~~~~~~~~~~~~~~~~~~~~~~~~~~~~~
~~~~~~~~~~~~~~~~______~~~~~~~~
~~~~~~~~~________....___~~~~~~
~~~~_______...........__~~~~~~
~~~~______.............__~~~~~
~~___~~_................_~~~~~
~___~~~_......^^^......__~~~~~
~~_~~~_......^^^^^....._~~~~~~
~~~~~~_.......^^......._~~~~~~
~~~~~__........^......_~~~~~~~
~~~~~__..............._~~~~~~~
~~~~~__..............._~~~~~~~
~~~~~_................__~~~~~~
~~~~~_.................._~~~~~
~~~~~_.................._~~~~~