~~~~~~~~~~~~~~~~~~~~~~~~~~~~~
~~~~~~~~~~~~~~~~______~~~~~~~
~~~~~~~~~________....___~~~~~
~~~~_______...........__~~~~~
~~~~______.............__~~~~
~~___~~_................_~~~~
~___~~~_......^^^......__~~~~
~~_~~~_......^^^^^....._~~~~~
~~~~~~_.......^^......._~~~~~
~~~~~__........^......_~~~~~~